rd	road
blvd	boulevard
pkwy	parkway
ln	lane
dr	drive
ave	avenue
av	avenue
st	street
alley	alley
br	bridge
cyn	canyon
ctr	center
cir	circle
ct	court
cres	crescent
expwy	expressway
fwy	freeway
hwy	highway
hill	hill
isl	island
jct	junction
lk	lake
lp	loop
mt	mount
mtn	mountain
pkwy	parkway
pl	place
plz	plaza
pt	port
r	river
sq	square
rte	route
ter	terrace
thwy	thruway
tr	trail
tpk	turnpike
way	way